
NO
SO
WE
EA

F
C

1111111111111111111111111
10000000000000000N0000001
10000000000000000000000011111111111111
10000000000000000000000000000000000001
11111111111111111110000000000000000001
11111111111111111111111110000000000001111111111111
11111111111111111111111111111111111000000000000001
                                  1000000000000001
                                  1000000000000001
                                  1000000000000001
                                  1111111111111111