NO ../../textures/NO.xpm
SO ../../textures/SO.xpm
WE ../../textures/WE.xpm
EA ../../textures/EA.xpm

F 147,155,155
C 123,123,123

1111111111111111111111111111111111111
1000000000000000000000000100000000001
1000100000000000000000000000000000001
1000000000000000000000000111111111111
1000000000010000000000000000000000001
1000000000010000000000000000000000001
1000000000010000000000000000000000001
1111111111111110000000000000000000001
1000000000000000000000000000000000001
1000000000000000000000000000000000001
1000000000000000000000000000000N00001
1000000000010000000000000000000000001
1111111111111111111111111111111111111