NO ../../textures/----------
SO ../../textures/----------
WE ../../textures/----------
EA ../../textures/----------





F 000,000,000
C 000,000,000

11111111111111111111111111
10000000000000000000000001
10000000000000000000000001111
10000000000000000000000000001
10000000000100000000000001111
10000000000100000000000001
10000000000100000000000001
11111111111111111111111111