NO ../../textures/----------
SO ../../textures/----------
WE ../../textures/----------
EA ../../textures/----------





F 000,000,000
C 000,000,000

1111111111111111111111111111111111111
1000000000000000000000000100000000001
1000100000000000000000000000000000001
1000000000000000000000000111111111111
1000000000010000000000000000000000001
1000000000010000000N00000000000000001
1000000000010000000000000000000000001
1111111111111110000000000000000000001
1000000000000000000000000000000000001
1000000000000000000000000000000000001
1000000000000000000000000000000000001
1000000000000000000000000000000000001
1000000000000000000000000000000000001
1111111111111111111111111111111111111