NO ../../textures/----------
SO ../../textures/----------
WE ../../textures/----------
EA ../../textures/----------





F 000,000,000
C 000,000,000

11111111111111
100000010001
1111111111111