NO ../../textures/NO.xpm
SO ../../textures/SO.xpm
WE ../../textures/WE.xpm
EA ../../textures/EA.xpm

F 147,155,155
C 123,123,123

        1111111111111111111111111
        1000000000110000000000001
        1011000001110000000000001 
        1001000000000000000000001
111111111011000000100000000000001
100000000011000000100000001111111
11110111111111011110000000001
11110000000000011110000000001
11000011111111011110000000001
1000001     100000000000000111111
1000001      11000000011000000001
1000001       1000000011010111111
1100001111111111111011110001
11110111 1110101 101111010001
11111111 1111111 111111111111