NO ../../textures/N.xpm
SO ../../textures/S.xpm
WE ../../textures/W.xpm
EA ../../textures/E.xpm

F 147,155,155
C 123,123,123

1111111111111111111111111111
1000000000000000000000000001
1000000101011111000000000001
1011000100000111000000000001
1001000100001000000000000001
1001000100110000000000000001
1001000101000000000000000001
1001000110000000000000000001
1001000100000000000000000001
1001000100000000000000000001
1001000100000000000000000001
1001000100000000000000000001
1001000100001000000000000001
1001000100000000000000000001
1001000110000000000000000001
1001000000000000000000000001
1001000110000000000000000001
1001000100000000000000000001
1001000101000000010000000001
1001000101000000000000000001
1001000100000000000000000001
1001000100000000000000000001
1001000100000000000000000001
1001000100000000000000000001
1001000100000000000000000001
1001000100000000110000000001
1001000100000000000000000001
1001000100000000000000000001
1001000100000000000000000001
1001000100000000001000000001
1001000100000000000000000001
1000101000000000000000000001
1001101000000000000100000001
1000001000000000000100000001
1101111001110000000100000001
1000000000000000000000000001
1000000000000000000000000001
1000000000000000000000000001
10000000000000N0000000000001
1111111111111111111111111111
