NO texture/N.xpm
SO texture/S.xpm
WE texture/W.xpm
EA texture/E.xpm

F 72,148,190
C 0,0,0

1111111111111111111111111111                      1111111111
1000000000000110000001011011                      1000000001
1111111111110110000001011011                      1000000001
1000000011110110000001011011                      1000000001
1111111111110111101111111011                      1111011111
1101100000000000000000000011                         101
110110000000000000000000001111111111111111           101
110110000000000000000000000000000000000001           101
110110000000000000000000001111111111111101           101
1100000000000000000000000011           101           101
1111100000000000000000000011           101           101  
1111101111111111011111111111           10111111111111101
    101        101                     10000000000000001
    101        101                     11111111111101111
    10111111111101                                101
    10000000000001                                101
    1111110111111111111111                        101
 1111000000000000000000001                        101
 1111011111111111111111101                        101
 1111011111111111111111101                        101
 1111011111111111111111101                        101
 1111011111111111111111101                        101
 1111011111111111111111101                        101
 1111011111111111111111101                        1011
 1000000000000000000000101                        1011
 1000000000000000000000101                        1001
 1000000000000000000000101                        1101
 1000000000000000000000101                        1001
 10000000000000000000001011111111111111111111111111001
 10000000N00000000000000000000000000000000000000000001
111111111111111111111111111111111111111111111111111111