NO texture/N.xpm
SO texture/S.xpm
WE texture/W.xpm
EA texture/E.xpm

F 96,96,96
C 0,0,0

1111111111111111111111111111                      
1000000000000110000001011011                      
1111111111110110000001011011                      
1000000011110110000001011011                      
110110000000000000000000001111111111111111           
110110000000000000000000000000000000000001           
110110000000000000000000001111111111111101           
1100000000000000000000000011           101           
1111100000000000000000000011           101             
1111101111111111011111111111           1N1
    101        101                     111
    101        101                    
    10111111111101                               
    10000000000001                               
    1111110111111111111111                      
 1111000000000000000000001                        
 1111011111111111111111101                      
 1111011111111111111111101                       
 1111011111111111111111101      
 1111011111111111111111101     
 1111011111111111111111101           
 1000000000000000000000101    
 1000000000000000000000101   
 1000000000000000000000101  
 1000000000000000000000101   
 1000000000000000000000101111
 1000000000000000000000000001
11111111111111111111111111111