NO ../../textures/NO.xpm
SO ../../textures/SO.xpm
WE ../../textures/WE.xpm
EA ../../textures/EA.xpm

F 147,155,155
C 123,123,123

1111111111111111111111111111
1000000000000000000000000001
1000000000000000000000000001
1000000000000000000000000001
1000000000000000000000000001
10000000N0000000000000000001
1000000000000000000000000001
1000000000000000000000000001
1000000000000000000000000001
1111100000111000000000001111
1000000000000000000000000001
1000000000000000000000000001
1000000000000000000000000001
1111111111111111111111111111