NO ../../textures/NO.xpm
SO ../../textures/SO.xpm
WE ../../textures/WE.xpm
EA ../../textures/EA.xpm

F 147,155,155
C 123,123,123

1111111111111111111111111111
1000000000000000000000000001
1000000101010111000000000001
1011000100000000000000000001
1001000100000000000000000001
1001000100000000000000000001
10010N0100000000000000000001
1000111000000000000000000001
1000000000000000000000000001
1000000000000000000000000001
1111111011110000000000000001
1000000000000000000000000001
1000000000000000000000000001
1111111111111111111111111111