NO ../../textures/NO.xpm
SO ../../textures/SO.xpm
WE ../../textures/WE.xpm
EA ../../textures/EA.xpm

F 147,155,155
C 123,123,123

1111111111111111111111111111
1000000000000000000000000001
1000000101011111000000000001
1011000100000111000000000001
1001000100001000000000000001
1001000100110000000000000001
1001000101000000000000000001
1001000110000000000000000001
1001000100000000000000000001
1000111000000000000000000001
1000000000000000000000000001
1000000000000000000000000001
1111111001110000000100000001
1000000000000000000000000001
1000000000000000000000000001
10000000000000N0000000000001
1000000000000000000000000001
1111111111111111111111111111